11111111111111
1E0000C0000001
100000C0000001
1E0000C0000P01
11111111111111
