111111111111111
1P00000C0000001
1000000E00000P1
111111111111111
