1111111111111111111111
1000000000000000000001
1000000000000000000001
1E000000000000000000P1
1111111111111111111111
