11111111111111
1000000C000001
100C00000000P1
11111111111111
