11111111111111
111000000000C1
1E1000000000P1
11111111111111
