1111111111
1C00000001
10C0000001
100C000001
1000C000E1
1111111111
