111111111111111111
100000000000000001
10000CCC00000P0001
1E0000000000000001
111111111111111111
